21 21
++++ ++++++++++++++++
++++        +++++++++
++++ ++++++  +++   ++
++ +++    ++     ++++
++   + ++ ++++++    +
++++   ++     ++ ++ +
++   +++ ++++ ++ ++ +
++ ++++  ++   +++++ +
++    + +++ +++     +
++ ++ + +++ ++++++ ++
++  +++ +   ++++   ++
++ ++++    ++++  ++ +
++   ++++       +++ +
++++    ++++ ++++++ +
+++  +++++++ ++++++ +
+++ +++    + ++++++ +
++++++++++        + +
++    +++  ++++++ +++
+++++     ++++    +++
+      ++      ++  ++
++++++++++++++ ++++++
