21 21
++++ ++++++++++++++++
++++       ++++++++++
++++ ++++++  +++   ++
++ + +    ++     ++++
++   + ++ ++++++    +
++++   ++     ++ ++ +
++   +++ ++++ ++ ++ +
++ ++++  ++   +++++ +
++    + +++ +++     +
++ ++ + +++ ++++++ ++
++  +++ +   ++++   ++
++ ++++    ++++  ++ +
++   +++        +++ +
++++    ++++ ++++++ +
+++  +++++++ ++++++ +
+++ +++    + ++++++ +
+++ ++++++        + +
++    +++  ++++++ +++
+++++     ++++    +++
+      ++      ++  ++
++++++++++++++ ++++++
